*******P*******
*******.*******
*******.*******
*******.*******
*******.*******
*******.*******
*******.*******
*******.*******
*******.*******
*******.*******
*******.*******
*******.*******
*******.*******
*******G*******
