******P********
*.****.*......*
*.****.******.*
*....*....***.*
****.****.***.*
****.****.....*
*.........*****
*.*********...*
*.*.........***
*.*.**.****...G
*....*.****.***
****.*.****.***
******......***
*......********
