******P********
******.********
******.********
******.********
******....*****
*********.*****
*********.....*
***.......*****
***.***********
***.***********
***....****...G
*......****.***
******.****.***
******......***
****...********
